.fc		支去
.fcu	去支云
+fcuu	云
.sgtk	酷酪
+ds		厅
.dsk	厅奇
.dskf	奇
+ghyi	寸
.skd	可束
+ski	束
+ognw	炼
+gus	来
.wgkr	使拿
+wgll	拿
+wglr	拿
-iyj	浏
+iyrj	浏
.uqw	次
.uqwy	次瓷
.def	有
.uwyc	冷羚
.sgjg	醒桓